1111111111111111111
1000000101000000E01
1000000101000000001
10000001110000C0001
10001110000000000P1
1111101111111111111