1111111111111111111
10000001 1000000E01
10000001 1000000001
10000001110000C0001
10000000000000000P1
1111111111111111111