11111111111111
10E10000000C01
10000111110001
1P0011E000C001
11111111111111