1111111111111111111111111111
10E10000000C0110E10000000C01
1000011111000110000111111110
1P0011E000C00110000111110001
1111111111111111111111111111